xxxxxxxxxxxxxxxx
x              x
x              x
x          l   x
x              x
x              x
x        c     x
x d r          x
x         a    x
x              x
x              x
xxxxxxxxxxxxxxxx
