xxxxxxxxxxxxxxxx
x              x
x              x
x  d      l    x
xd             x
x              x
x d      c     x
x  d r         x
xd        a    x
x d    l    l  x
x              x
xxxxxxxxxxxxxxxx
